call_set_name,total_callable_sites,homozygous_reference_count,homozygous_alternate_count,heterozygous_count,total_snvs,percentage_heterozygous_among_snvs,percentage_homozygous_alternate_among_snvs
NA20414,1263,1112,36,115,151,76.16,23.84
NA20299,1263,1110,37,116,153,75.82,24.18
NA20127,1263,1111,41,111,152,73.03,26.97
HG00734,1263,1126,37,100,137,72.99,27.01
NA19923,1263,1124,38,101,139,72.66,27.34
HG01342,1263,1108,43,112,155,72.26,27.74
NA19701,1263,1123,39,101,140,72.14,27.86
HG01095,1263,1138,35,90,125,72.00,28.00
NA19985,1263,1110,43,110,153,71.90,28.10
NA19038,1263,1101,46,116,162,71.60,28.40
NA19712,1263,1105,45,113,158,71.52,28.48
HG00235,1263,1158,30,75,105,71.43,28.57
NA19914,1263,1123,40,100,140,71.43,28.57
NA19474,1263,1089,50,124,174,71.26,28.74
NA20359,1263,1100,47,116,163,71.17,28.83
NA12763,1263,1149,33,81,114,71.05,28.95
NA19185,1263,1112,44,107,151,70.86,29.14
NA19398,1263,1099,48,116,164,70.73,29.27
NA19129,1263,1096,49,118,167,70.66,29.34
NA19704,1263,1120,42,101,143,70.63,29.37
NA19390,1263,1117,43,103,146,70.55,29.45
NA19471,1263,1084,53,126,179,70.39,29.61
NA19099,1263,1128,40,95,135,70.37,29.63
NA19396,1263,1101,48,114,162,70.37,29.63
NA19921,1263,1118,43,102,145,70.34,29.66
NA19625,1263,1108,46,109,155,70.32,29.68
NA19835,1263,1105,47,111,158,70.25,29.75
NA20802,1263,1149,34,80,114,70.18,29.82
HG00364,1263,1163,30,70,100,70.00,30.00
HG01052,1263,1113,45,105,150,70.00,30.00
NA18517,1263,1093,51,119,170,70.00,30.00
NA19379,1263,1103,48,112,160,70.00,30.00
HG01188,1263,1120,43,100,143,69.93,30.07
NA19713,1263,1110,46,107,153,69.93,30.07
NA20412,1263,1110,46,107,153,69.93,30.07
NA19324,1263,1107,47,109,156,69.87,30.13
NA19355,1263,1107,47,109,156,69.87,30.13
NA19746,1263,1134,39,90,129,69.77,30.23
HG01551,1263,1131,40,92,132,69.70,30.30
NA19137,1263,1098,50,115,165,69.70,30.30
NA18907,1263,1108,47,108,155,69.68,30.32
HG00737,1263,1141,37,85,122,69.67,30.33
NA20317,1263,1099,50,114,164,69.51,30.49
NA20336,1263,1119,44,100,144,69.44,30.56
NA18867,1263,1106,48,109,157,69.43,30.57
NA19235,1263,1104,49,110,159,69.18,30.82
NA19149,1263,1098,51,114,165,69.09,30.91
NA19472,1263,1095,52,116,168,69.05,30.95
NA19470,1263,1105,49,109,158,68.99,31.01
HG00104,1263,1160,32,71,103,68.93,31.07
NA19222,1263,1104,50,109,159,68.55,31.45
NA19438,1263,1104,50,109,159,68.55,31.45
NA20363,1263,1104,50,109,159,68.55,31.45
HG00309,1263,1155,34,74,108,68.52,31.48
NA18858,1263,1101,51,111,162,68.52,31.48
NA19457,1263,1095,53,115,168,68.45,31.55
HG00337,1263,1149,36,78,114,68.42,31.58
NA19446,1263,1102,51,110,161,68.32,31.68
NA20341,1263,1080,58,125,183,68.31,31.69
NA19257,1263,1115,47,101,148,68.24,31.76
NA19463,1263,1093,54,116,170,68.24,31.76
NA19901,1263,1097,53,113,166,68.07,31.93
HG01105,1263,1141,39,83,122,68.03,31.97
HG00238,1263,1151,36,76,112,67.86,32.14
HG01080,1263,1148,37,78,115,67.83,32.17
NA18870,1263,1117,47,99,146,67.81,32.19
NA19437,1263,1117,47,99,146,67.81,32.19
NA18505,1263,1096,54,113,167,67.66,32.34
NA20322,1263,1112,49,102,151,67.55,32.45
HG00237,1263,1149,37,77,114,67.54,32.46
HG01183,1263,1149,37,77,114,67.54,32.46
NA19316,1263,1094,55,114,169,67.46,32.54
HG01366,1263,1119,47,97,144,67.36,32.64
HG00355,1263,1159,34,70,104,67.31,32.69
NA19469,1263,1107,51,105,156,67.31,32.69
NA18499,1263,1104,52,107,159,67.30,32.70
NA20357,1263,1101,53,109,162,67.28,32.72
HG00641,1263,1147,38,78,116,67.24,32.76
HG01360,1263,1144,39,80,119,67.23,32.77
NA19172,1263,1102,53,108,161,67.08,32.92
NA11993,1263,1157,35,71,106,66.98,33.02
HG01492,1263,1146,39,78,117,66.67,33.33
NA18508,1263,1122,47,94,141,66.67,33.33
NA19095,1263,1119,48,96,144,66.67,33.33
NA19108,1263,1119,48,96,144,66.67,33.33
NA19794,1263,1146,39,78,117,66.67,33.33
NA19381,1263,1105,53,105,158,66.46,33.54
NA20334,1263,1117,49,97,146,66.44,33.56
HG01171,1263,1144,40,79,119,66.39,33.61
HG01251,1263,1150,38,75,113,66.37,33.63
NA19190,1263,1106,53,104,157,66.24,33.76
NA19456,1263,1106,53,104,157,66.24,33.76
NA19310,1263,1109,52,102,154,66.23,33.77
NA20296,1263,1109,52,102,154,66.23,33.77
NA19439,1263,1118,49,96,145,66.21,33.79
NA19707,1263,1136,43,84,127,66.14,33.86
NA20804,1263,1157,36,70,106,66.04,33.96
NA19449,1263,1107,53,103,156,66.03,33.97
NA20531,1263,1160,35,68,103,66.02,33.98
NA19131,1263,1113,51,99,150,66.00,34.00
NA18873,1263,1122,48,93,141,65.96,34.04
NA18916,1263,1102,55,106,161,65.84,34.16
NA18511,1263,1105,54,104,158,65.82,34.18
NA19152,1263,1105,54,104,158,65.82,34.18
NA19431,1263,1105,54,104,158,65.82,34.18
NA19434,1263,1108,53,102,155,65.81,34.19
HG01257,1263,1149,39,75,114,65.79,34.21
HG01278,1263,1149,39,75,114,65.79,34.21
HG01375,1263,1149,39,75,114,65.79,34.21
NA19321,1263,1126,47,90,137,65.69,34.31
HG01462,1263,1135,44,84,128,65.63,34.38
NA19445,1263,1109,53,101,154,65.58,34.42
NA20766,1263,1141,42,80,122,65.57,34.43
HG01098,1263,1153,38,72,110,65.45,34.55
NA18957,1263,1153,38,72,110,65.45,34.55
NA19204,1263,1104,55,104,159,65.41,34.59
NA19473,1263,1110,53,100,153,65.36,34.64
NA19819,1263,1110,53,100,153,65.36,34.64
HG01390,1263,1119,50,94,144,65.28,34.72
NA19114,1263,1099,57,107,164,65.24,34.76
NA19102,1263,1102,56,105,161,65.22,34.78
NA19197,1263,1102,56,105,161,65.22,34.78
NA20294,1263,1120,50,93,143,65.03,34.97
NA20522,1263,1152,39,72,111,64.86,35.14
NA20790,1263,1152,39,72,111,64.86,35.14
HG01626,1263,1172,32,59,91,64.84,35.16
HG01345,1263,1155,38,70,108,64.81,35.19
NA20276,1263,1121,50,92,142,64.79,35.21
NA20287,1263,1121,50,92,142,64.79,35.21
NA12830,1263,1158,37,68,105,64.76,35.24
NA20339,1263,1107,55,101,156,64.74,35.26
NA19468,1263,1116,52,95,147,64.63,35.37
NA19404,1263,1105,56,102,158,64.56,35.44
HG01620,1263,1153,39,71,110,64.55,35.45
NA18978,1263,1159,37,67,104,64.42,35.58
NA19118,1263,1131,47,85,132,64.39,35.61
NA19403,1263,1120,51,92,143,64.34,35.66
NA19681,1263,1134,46,83,129,64.34,35.66
HG00146,1263,1151,40,72,112,64.29,35.71
HG00327,1263,1151,40,72,112,64.29,35.71
NA20508,1263,1165,35,63,98,64.29,35.71
NA19377,1263,1098,59,106,165,64.24,35.76
HG00638,1263,1140,44,79,123,64.23,35.77
NA19093,1263,1107,56,100,156,64.10,35.90
NA19328,1263,1107,56,100,156,64.10,35.90
NA19725,1263,1146,42,75,117,64.10,35.90
NA19351,1263,1121,51,91,142,64.08,35.92
HG00356,1263,1163,36,64,100,64.00,36.00
NA11920,1263,1163,36,64,100,64.00,36.00
NA20799,1263,1163,36,64,100,64.00,36.00
HG00324,1263,1152,40,71,111,63.96,36.04
NA20502,1263,1155,39,69,108,63.89,36.11
NA19338,1263,1122,51,90,141,63.83,36.17
HG00249,1263,1158,38,67,105,63.81,36.19
NA19315,1263,1100,59,104,163,63.80,36.20
HG01174,1263,1147,42,74,116,63.79,36.21
NA19719,1263,1147,42,74,116,63.79,36.21
HG01275,1263,1161,37,65,102,63.73,36.27
NA19672,1263,1150,41,72,113,63.72,36.28
NA19462,1263,1106,57,100,157,63.69,36.31
HG00176,1263,1142,44,77,121,63.64,36.36
HG00306,1263,1164,36,63,99,63.64,36.36
HG00732,1263,1153,40,70,110,63.64,36.36
HG00247,1263,1145,43,75,118,63.56,36.44
HG00452,1263,1156,39,68,107,63.55,36.45
NA20772,1263,1156,39,68,107,63.55,36.45
HG01140,1263,1137,46,80,126,63.49,36.51
NA19313,1263,1118,53,92,145,63.45,36.55
NA19758,1263,1140,45,78,123,63.41,36.59
NA12778,1263,1151,41,71,112,63.39,36.61
NA19770,1263,1151,41,71,112,63.39,36.61
HG01384,1263,1135,47,81,128,63.28,36.72
HG00134,1263,1157,39,67,106,63.21,36.79
NA18975,1263,1157,39,67,106,63.21,36.79
NA20344,1263,1122,52,89,141,63.12,36.88
HG00578,1263,1141,45,77,122,63.11,36.89
HG01073,1263,1141,45,77,122,63.11,36.89
NA20505,1263,1160,38,65,103,63.11,36.89
HG01070,1263,1133,48,82,130,63.08,36.92
HG00097,1263,1152,41,70,111,63.06,36.94
HG01489,1263,1152,41,70,111,63.06,36.94
NA19401,1263,1106,58,99,157,63.06,36.94
NA18861,1263,1109,57,97,154,62.99,37.01
NA18951,1263,1147,43,73,116,62.93,37.07
NA19147,1263,1112,56,95,151,62.91,37.09
NA20773,1263,1166,36,61,97,62.89,37.11
HG00334,1263,1158,39,66,105,62.86,37.14
NA19116,1263,1115,55,93,148,62.84,37.16
NA20819,1263,1148,43,72,115,62.61,37.39
NA19917,1263,1100,61,102,163,62.58,37.42
HG00740,1263,1151,42,70,112,62.50,37.50
HG01198,1263,1143,45,75,120,62.50,37.50
NA20289,1263,1095,63,105,168,62.50,37.50
NA07037,1263,1154,41,68,109,62.39,37.61
NA12749,1263,1154,41,68,109,62.39,37.61
NA19675,1263,1154,41,68,109,62.39,37.61
NA19776,1263,1146,44,73,117,62.39,37.61
HG00330,1263,1162,38,63,101,62.38,37.62
HG00276,1263,1157,40,66,106,62.26,37.74
HG01618,1263,1157,40,66,106,62.26,37.74
NA19399,1263,1099,62,102,164,62.20,37.80
NA19785,1263,1152,42,69,111,62.16,37.84
HG01168,1263,1163,38,62,100,62.00,38.00
NA20282,1263,1113,57,93,150,62.00,38.00
NA20807,1263,1163,38,62,100,62.00,38.00
NA20542,1263,1150,43,70,113,61.95,38.05
HG00272,1263,1158,40,65,105,61.90,38.10
HG00359,1263,1166,37,60,97,61.86,38.14
HG01125,1263,1166,37,60,97,61.86,38.14
HG00339,1263,1161,39,63,102,61.76,38.24
NA20332,1263,1127,52,84,136,61.76,38.24
NA19036,1263,1114,57,92,149,61.74,38.26
NA19436,1263,1101,62,100,162,61.73,38.27
NA19327,1263,1109,59,95,154,61.69,38.31
HG01272,1263,1156,41,66,107,61.68,38.32
HG01061,1263,1143,46,74,120,61.67,38.33
NA19467,1263,1117,56,90,146,61.64,38.36
NA12400,1263,1151,43,69,112,61.61,38.39
NA20786,1263,1159,40,64,104,61.54,38.46
NA18523,1263,1115,57,91,148,61.49,38.51
HG00125,1263,1154,42,67,109,61.47,38.53
HG00171,1263,1154,42,67,109,61.47,38.53
NA18630,1263,1154,42,67,109,61.47,38.53
NA19779,1263,1144,46,73,119,61.34,38.66
HG00253,1263,1157,41,65,106,61.32,38.68
HG00319,1263,1157,41,65,106,61.32,38.68
NA20541,1263,1152,43,68,111,61.26,38.74
NA20775,1263,1152,43,68,111,61.26,38.74
HG00137,1263,1165,38,60,98,61.22,38.78
NA20540,1263,1165,38,60,98,61.22,38.78
HG01113,1263,1160,40,63,103,61.17,38.83
NA11892,1263,1160,40,63,103,61.17,38.83
NA20529,1263,1160,40,63,103,61.17,38.83
NA20800,1263,1160,40,63,103,61.17,38.83
NA12890,1263,1155,42,66,108,61.11,38.89
NA20589,1263,1155,42,66,108,61.11,38.89
HG00313,1263,1150,44,69,113,61.06,38.94
NA18560,1263,1150,44,69,113,61.06,38.94
HG01191,1263,1158,41,64,105,60.95,39.05
NA18520,1263,1112,59,92,151,60.93,39.07
NA18912,1263,1112,59,92,151,60.93,39.07
HG00133,1263,1153,43,67,110,60.91,39.09
NA19773,1263,1143,47,73,120,60.83,39.17
HG00135,1263,1166,38,59,97,60.82,39.18
HG00258,1263,1166,38,59,97,60.82,39.18
NA12283,1263,1161,40,62,102,60.78,39.22
NA12341,1263,1161,40,62,102,60.78,39.22
NA12273,1263,1156,42,65,107,60.75,39.25
NA20761,1263,1156,42,65,107,60.75,39.25
HG01354,1263,1159,41,63,104,60.58,39.42
NA10847,1263,1159,41,63,104,60.58,39.42
HG00274,1263,1154,43,66,109,60.55,39.45
NA19755,1263,1154,43,66,109,60.55,39.45
HG01055,1263,1149,45,69,114,60.53,39.47
NA12717,1263,1149,45,69,114,60.53,39.47
NA19440,1263,1106,62,95,157,60.51,39.49
NA12383,1263,1144,47,72,119,60.50,39.50
HG00122,1263,1157,42,64,106,60.38,39.62
HG01498,1263,1157,42,64,106,60.38,39.62
HG01102,1263,1152,44,67,111,60.36,39.64
HG00349,1263,1170,37,56,93,60.22,39.78
HG00178,1263,1165,39,59,98,60.20,39.80
HG00328,1263,1155,43,65,108,60.19,39.81
HG00344,1263,1160,41,62,103,60.19,39.81
NA20503,1263,1155,43,65,108,60.19,39.81
NA11894,1263,1145,47,71,118,60.17,39.83
HG00231,1263,1153,44,66,110,60.00,40.00
NA19209,1263,1108,62,93,155,60.00,40.00
NA19391,1263,1128,54,81,135,60.00,40.00
NA18489,1263,1116,59,88,147,59.86,40.14
NA18502,1263,1116,59,88,147,59.86,40.14
NA18634,1263,1151,45,67,112,59.82,40.18
NA12751,1263,1156,43,64,107,59.81,40.19
NA07056,1263,1161,41,61,102,59.80,40.20
NA12843,1263,1161,41,61,102,59.80,40.20
NA18924,1263,1114,60,89,149,59.73,40.27
NA19909,1263,1124,56,83,139,59.71,40.29
NA19651,1263,1154,44,65,109,59.63,40.37
HG00232,1263,1159,42,62,104,59.62,40.38
HG00174,1263,1147,47,69,116,59.48,40.52
HG00525,1263,1147,47,69,116,59.48,40.52
HG01137,1263,1147,47,69,116,59.48,40.52
NA19678,1263,1147,47,69,116,59.48,40.52
NA20826,1263,1147,47,69,116,59.48,40.52
HG00378,1263,1162,41,60,101,59.41,40.59
HG00102,1263,1167,39,57,96,59.38,40.63
HG00629,1263,1150,46,67,113,59.29,40.71
HG01067,1263,1150,46,67,113,59.29,40.71
NA12873,1263,1155,44,64,108,59.26,40.74
NA12815,1263,1165,40,58,98,59.18,40.82
NA19740,1263,1148,47,68,115,59.13,40.87
HG00106,1263,1153,45,65,110,59.09,40.91
NA19684,1263,1158,43,62,105,59.05,40.95
HG00111,1263,1163,41,59,100,59.00,41.00
HG00254,1263,1163,41,59,100,59.00,41.00
NA19435,1263,1107,64,92,156,58.97,41.03
HG00620,1263,1156,44,63,107,58.88,41.12
NA12275,1263,1161,42,60,102,58.82,41.18
HG00177,1263,1166,40,57,97,58.76,41.24
HG00240,1263,1166,40,57,97,58.76,41.24
NA19737,1263,1166,40,57,97,58.76,41.24
NA20756,1263,1154,45,64,109,58.72,41.28
HG00263,1263,1159,43,61,104,58.65,41.35
HG00320,1263,1159,43,61,104,58.65,41.35
HG00323,1263,1159,43,61,104,58.65,41.35
HG00353,1263,1159,43,61,104,58.65,41.35
NA11931,1263,1159,43,61,104,58.65,41.35
HG00581,1263,1147,48,68,116,58.62,41.38
HG01623,1263,1157,44,62,106,58.49,41.51
NA19080,1263,1157,44,62,106,58.49,41.51
NA18909,1263,1109,64,90,154,58.44,41.56
HG00376,1263,1162,42,59,101,58.42,41.58
NA19225,1263,1114,62,87,149,58.39,41.61
HG00367,1263,1155,45,63,108,58.33,41.67
NA19084,1263,1148,48,67,115,58.26,41.74
NA19660,1263,1148,48,67,115,58.26,41.74
NA12058,1263,1153,46,64,110,58.18,41.82
NA18582,1263,1158,44,61,105,58.10,41.90
HG00684,1263,1139,52,72,124,58.06,41.94
HG01465,1263,1170,39,54,93,58.06,41.94
HG00128,1263,1163,42,58,100,58.00,42.00
HG00373,1263,1163,42,58,100,58.00,42.00
NA18595,1263,1163,42,58,100,58.00,42.00
HG00180,1263,1156,45,62,107,57.94,42.06
HG00275,1263,1156,45,62,107,57.94,42.06
HG00245,1263,1168,40,55,95,57.89,42.11
HG00282,1263,1149,48,66,114,57.89,42.11
NA19078,1263,1149,48,66,114,57.89,42.11
HG00130,1263,1161,43,59,102,57.84,42.16
NA20760,1263,1161,43,59,102,57.84,42.16
HG01351,1263,1154,46,63,109,57.80,42.20
HG00501,1263,1147,49,67,116,57.76,42.24
HG00357,1263,1166,41,56,97,57.73,42.27
HG00118,1263,1159,44,60,104,57.69,42.31
NA07000,1263,1159,44,60,104,57.69,42.31
HG01108,1263,1126,58,79,137,57.66,42.34
NA18640,1263,1152,47,64,111,57.66,42.34
HG00593,1263,1157,45,61,106,57.55,42.45
NA20504,1263,1157,45,61,106,57.55,42.45
HG00239,1263,1169,40,54,94,57.45,42.55
HG00419,1263,1169,40,54,94,57.45,42.55
HG00120,1263,1162,43,58,101,57.43,42.57
NA18642,1263,1162,43,58,101,57.43,42.57
NA18541,1263,1148,49,66,115,57.39,42.61
NA19247,1263,1113,64,86,150,57.33,42.67
NA19648,1263,1160,44,59,103,57.28,42.72
HG00173,1263,1153,47,63,110,57.27,42.73
NA19065,1263,1153,47,63,110,57.27,42.73
HG00236,1263,1151,48,64,112,57.14,42.86
HG01134,1263,1158,45,60,105,57.14,42.86
NA18596,1263,1151,48,64,112,57.14,42.86
NA19722,1263,1158,45,60,105,57.14,42.86
NA18602,1263,1149,49,65,114,57.02,42.98
NA20585,1263,1149,49,65,114,57.02,42.98
HG00315,1263,1156,46,61,107,57.01,42.99
HG00179,1263,1170,40,53,93,56.99,43.01
HG00150,1263,1154,47,62,109,56.88,43.12
HG01441,1263,1154,47,62,109,56.88,43.12
NA20507,1263,1154,47,62,109,56.88,43.12
HG00266,1263,1161,44,58,102,56.86,43.14
NA20771,1263,1161,44,58,102,56.86,43.14
HG00269,1263,1152,48,63,111,56.76,43.24
HG00446,1263,1152,48,63,111,56.76,43.24
HG00611,1263,1152,48,63,111,56.76,43.24
NA12004,1263,1152,48,63,111,56.76,43.24
NA12718,1263,1152,48,63,111,56.76,43.24
HG00543,1263,1159,45,59,104,56.73,43.27
NA06989,1263,1159,45,59,104,56.73,43.27
HG01083,1263,1143,52,68,120,56.67,43.33
HG01522,1263,1150,49,64,113,56.64,43.36
NA18538,1263,1150,49,64,113,56.64,43.36
HG00285,1263,1157,46,60,106,56.60,43.40
HG00672,1263,1157,46,60,106,56.60,43.40
NA12046,1263,1164,43,56,99,56.57,43.43
NA20535,1263,1164,43,56,99,56.57,43.43
HG00596,1263,1148,50,65,115,56.52,43.48
NA18617,1263,1155,47,61,108,56.48,43.52
HG00100,1263,1162,44,57,101,56.44,43.56
NA18542,1263,1153,48,62,110,56.36,43.64
NA20517,1263,1153,48,62,110,56.36,43.64
HG00123,1263,1160,45,58,103,56.31,43.69
NA18610,1263,1160,45,58,103,56.31,43.69
NA18555,1263,1144,52,67,119,56.30,43.70
HG00384,1263,1165,43,55,98,56.12,43.88
HG00261,1263,1156,47,60,107,56.07,43.93
HG00250,1263,1147,51,65,116,56.03,43.97
NA18941,1263,1147,51,65,116,56.03,43.97
HG00121,1263,1163,44,56,100,56.00,44.00
HG00318,1263,1163,44,56,100,56.00,44.00
NA20828,1263,1154,48,61,109,55.96,44.04
HG00110,1263,1161,45,57,102,55.88,44.12
HG00259,1263,1161,45,57,102,55.88,44.12
HG00590,1263,1152,49,62,111,55.86,44.14
HG00690,1263,1152,49,62,111,55.86,44.14
NA18535,1263,1152,49,62,111,55.86,44.14
HG00381,1263,1168,42,53,95,55.79,44.21
NA12006,1263,1168,42,53,95,55.79,44.21
HG00404,1263,1159,46,58,104,55.77,44.23
HG00127,1263,1150,50,63,113,55.75,44.25
NA18976,1263,1150,50,63,113,55.75,44.25
NA18987,1263,1150,50,63,113,55.75,44.25
NA18631,1263,1139,55,69,124,55.65,44.35
HG00332,1263,1155,48,60,108,55.56,44.44
NA19395,1263,1119,64,80,144,55.56,44.44
NA12761,1263,1162,45,56,101,55.45,44.55
NA19657,1263,1153,49,61,110,55.45,44.55
HG00268,1263,1171,41,51,92,55.43,44.57
NA18981,1263,1151,50,62,112,55.36,44.64
HG00608,1263,1160,46,57,103,55.34,44.66
NA18565,1263,1160,46,57,103,55.34,44.66
NA20795,1263,1160,46,57,103,55.34,44.66
NA18933,1263,1113,67,83,150,55.33,44.67
HG00350,1263,1169,42,52,94,55.32,44.68
HG00437,1263,1149,51,63,114,55.26,44.74
NA18574,1263,1149,51,63,114,55.26,44.74
HG00270,1263,1158,47,58,105,55.24,44.76
HG00693,1263,1158,47,58,105,55.24,44.76
NA11933,1263,1158,47,58,105,55.24,44.76
HG00464,1263,1147,52,64,116,55.17,44.83
HG00257,1263,1156,48,59,107,55.14,44.86
NA18939,1263,1156,48,59,107,55.14,44.86
NA18567,1263,1145,53,65,118,55.08,44.92
HG01378,1263,1154,49,60,109,55.05,44.95
NA18980,1263,1154,49,60,109,55.05,44.95
NA11995,1263,1163,45,55,100,55.00,45.00
HG00566,1263,1152,50,61,111,54.95,45.05
NA18998,1263,1152,50,61,111,54.95,45.05
HG00428,1263,1150,51,62,113,54.87,45.13
HG00449,1263,1150,51,62,113,54.87,45.13
NA20314,1263,1150,51,62,113,54.87,45.13
NA20808,1263,1150,51,62,113,54.87,45.13
HG00473,1263,1159,47,57,104,54.81,45.19
HG00699,1263,1159,47,57,104,54.81,45.19
HG01357,1263,1159,47,57,104,54.81,45.19
HG01149,1263,1148,52,63,115,54.78,45.22
HG00154,1263,1168,43,52,95,54.74,45.26
NA20769,1263,1168,43,52,95,54.74,45.26
HG01516,1263,1157,48,58,106,54.72,45.28
NA19752,1263,1157,48,58,106,54.72,45.28
NA19782,1263,1155,49,59,108,54.63,45.37
HG00443,1263,1153,50,60,110,54.55,45.45
NA18566,1263,1153,50,60,110,54.55,45.45
HG00158,1263,1162,46,55,101,54.46,45.54
NA20818,1263,1162,46,55,101,54.46,45.54
NA12489,1263,1160,47,56,103,54.37,45.63
NA19663,1263,1147,53,63,116,54.31,45.69
NA18576,1263,1158,48,57,105,54.29,45.71
HG00124,1263,1156,49,58,107,54.21,45.79
NA18526,1263,1156,49,58,107,54.21,45.79
HG00705,1263,1154,50,59,109,54.13,45.87
HG00346,1263,1165,45,53,98,54.08,45.92
NA18949,1263,1165,45,53,98,54.08,45.92
HG00657,1263,1152,51,60,111,54.05,45.95
NA12044,1263,1163,46,54,100,54.00,46.00
NA19761,1263,1150,52,61,113,53.98,46.02
HG00458,1263,1161,47,55,102,53.92,46.08
HG00479,1263,1161,47,55,102,53.92,46.08
HG00560,1263,1148,53,62,115,53.91,46.09
NA12287,1263,1159,48,56,104,53.85,46.15
NA20582,1263,1159,48,56,104,53.85,46.15
NA18570,1263,1142,56,65,121,53.72,46.28
NA18954,1263,1153,51,59,110,53.64,46.36
HG00554,1263,1151,52,60,112,53.57,46.43
NA18626,1263,1151,52,60,112,53.57,46.43
HG01456,1263,1149,53,61,114,53.51,46.49
NA18946,1263,1149,53,61,114,53.51,46.49
NA18527,1263,1160,48,55,103,53.40,46.60
NA20813,1263,1160,48,55,103,53.40,46.60
NA20768,1263,1158,49,56,105,53.33,46.67
HG00326,1263,1156,50,57,107,53.27,46.73
NA18964,1263,1156,50,57,107,53.27,46.73
NA19654,1263,1156,50,57,107,53.27,46.73
HG00584,1263,1154,51,58,109,53.21,46.79
HG00281,1263,1150,53,60,113,53.10,46.90
NA18999,1263,1150,53,60,113,53.10,46.90
NA19788,1263,1161,48,54,102,52.94,47.06
HG00476,1263,1153,52,58,110,52.73,47.27
NA20774,1263,1153,52,58,110,52.73,47.27
NA19764,1263,1151,53,59,112,52.68,47.32
NA18616,1263,1149,54,60,114,52.63,47.37
HG00383,1263,1162,48,53,101,52.48,47.52
NA18627,1263,1162,48,53,101,52.48,47.52
HG00702,1263,1152,53,58,111,52.25,47.75
NA18599,1263,1150,54,59,113,52.21,47.79
NA19054,1263,1148,55,60,115,52.17,47.83
NA19074,1263,1146,56,61,117,52.14,47.86
NA18525,1263,1163,48,52,100,52.00,48.00
NA18579,1263,1157,51,55,106,51.89,48.11
NA19716,1263,1157,51,55,106,51.89,48.11
NA18571,1263,1153,53,57,110,51.82,48.18
NA19059,1263,1153,53,57,110,51.82,48.18
NA20753,1263,1153,53,57,110,51.82,48.18
NA18950,1263,1151,54,58,112,51.79,48.21
NA19077,1263,1151,54,58,112,51.79,48.21
HG01495,1263,1147,56,60,116,51.72,48.28
NA18973,1263,1164,48,51,99,51.52,48.48
HG00343,1263,1162,49,52,101,51.49,48.51
NA20757,1263,1160,50,53,103,51.46,48.54
NA18628,1263,1158,51,54,105,51.43,48.57
NA18564,1263,1154,53,56,109,51.38,48.62
NA19749,1263,1154,53,56,109,51.38,48.62
NA18552,1263,1152,54,57,111,51.35,48.65
HG00708,1263,1150,55,58,113,51.33,48.67
NA18593,1263,1150,55,58,113,51.33,48.67
HG00362,1263,1175,43,45,88,51.14,48.86
HG00262,1263,1171,45,47,92,51.09,48.91
NA11830,1263,1167,47,49,96,51.04,48.96
HG00255,1263,1163,49,51,100,51.00,49.00
NA18968,1263,1161,50,52,102,50.98,49.02
NA19003,1263,1161,50,52,102,50.98,49.02
NA19081,1263,1161,50,52,102,50.98,49.02
NA18547,1263,1159,51,53,104,50.96,49.04
NA18528,1263,1157,52,54,106,50.94,49.06
NA19728,1263,1155,53,55,108,50.93,49.07
NA19734,1263,1155,53,55,108,50.93,49.07
NA19010,1263,1153,54,56,110,50.91,49.09
NA18956,1263,1151,55,57,112,50.89,49.11
NA18614,1263,1147,57,59,116,50.86,49.14
NA19057,1263,1147,57,59,116,50.86,49.14
HG00331,1263,1168,47,48,95,50.53,49.47
NA18537,1263,1162,50,51,101,50.50,49.50
NA19731,1263,1158,52,53,105,50.48,49.52
HG00635,1263,1154,54,55,109,50.46,49.54
NA18550,1263,1154,54,55,109,50.46,49.54
NA18592,1263,1154,54,55,109,50.46,49.54
HG00614,1263,1150,56,57,113,50.44,49.56
NA12348,1263,1150,56,57,113,50.44,49.56
NA18545,1263,1150,56,57,113,50.44,49.56
HG00531,1263,1161,51,51,102,50.00,50.00
NA18947,1263,1155,54,54,108,50.00,50.00
NA20797,1263,1169,47,47,94,50.00,50.00
NA18942,1263,1150,57,56,113,49.56,50.44
HG00407,1263,1162,51,50,101,49.50,50.50
NA18532,1263,1153,56,54,110,49.09,50.91
NA18597,1263,1161,52,50,102,49.02,50.98
NA18992,1263,1165,50,48,98,48.98,51.02
NA20533,1263,1169,48,46,94,48.94,51.06
HG00513,1263,1152,57,54,111,48.65,51.35
NA18615,1263,1154,56,53,109,48.62,51.38
NA19087,1263,1154,56,53,109,48.62,51.38
HG00654,1263,1156,55,52,107,48.60,51.40
HG00663,1263,1158,54,51,105,48.57,51.43
NA18963,1263,1160,53,50,103,48.54,51.46
HG01519,1263,1164,51,48,99,48.48,51.52
NA18641,1263,1166,50,47,97,48.45,51.55
HG00099,1263,1168,49,46,95,48.42,51.58
NA12249,1263,1170,48,45,93,48.39,51.61
HG00557,1263,1159,54,50,104,48.08,51.92
NA18553,1263,1159,54,50,104,48.08,51.92
HG00651,1263,1163,52,48,100,48.00,52.00
NA18577,1263,1152,58,53,111,47.75,52.25
NA18619,1263,1156,56,51,107,47.66,52.34
NA19002,1263,1158,55,50,105,47.62,52.38
NA19064,1263,1160,54,49,103,47.57,52.43
HG00377,1263,1172,48,43,91,47.25,52.75
HG00233,1263,1158,56,49,105,46.67,53.33
HG00626,1263,1162,55,46,101,45.54,54.46
NA18573,1263,1172,50,41,91,45.05,54.95
NA18618,1263,1162,56,45,101,44.55,55.45
HG00534,1263,1146,65,52,117,44.44,55.56
HG00537,1263,1155,61,47,108,43.52,56.48
HG00422,1263,1157,60,46,106,43.40,56.60
NA18539,1263,1162,58,43,101,42.57,57.43
HG00361,1263,1184,53,26,79,32.91,67.09
NA20530,1263,1177,67,19,86,22.09,77.91
NA20506,1263,1183,67,13,80,16.25,83.75
NA19332,1263,1148,105,10,115,8.70,91.30
