upper_latin,count_2015,count_1995,count_growth,alive_growth,dead_growth
PLATANUS X ACERIFOLIA,87014,0,87014,87014,0
GLEDITSIA TRIACANTHOS VAR. INERMIS,64264,0,64264,64263,1
PRUNUS,29279,0,29279,29279,0
PYRUS CALLERYANA,58931,31295,27636,28636,-359
ZELKOVA SERRATA,29258,5740,23518,23763,-94
STYPHNOLOBIUM JAPONICUM,19338,0,19338,19338,0
QUERCUS PALUSTRIS,53185,36553,16632,17440,-298
TILIA AMERICANA,13530,95,13435,13436,0
TILIA TOMENTOSA,7995,57,7938,7938,0
GINKGO BILOBA,21024,13758,7266,7937,-248