match_id,player1_id,player1_runs,player2_id,player2_runs,total_partnership_runs
335987,2,45,4,12,57
335988,19,42,23,31,73
335989,42,52,40,50,102
335990,11,38,9,16,54
335991,56,22,59,9,31
335992,35,36,32,30,66
335993,41,75,42,25,100
335994,21,53,18,41,94
335995,56,73,57,36,109
335996,26,54,24,16,70
335997,32,57,74,44,101
335998,20,43,18,36,79
335999,53,109,55,37,146
336000,28,40,64,15,55
336001,20,65,19,29,94
336002,71,64,46,37,101
336003,42,50,40,48,98
336004,64,45,100,31,76
336005,1,34,4,31,65
336006,41,71,40,39,110
336007,97,47,53,45,92
336008,4,58,62,46,104
336009,45,24,46,22,46
336010,101,32,74,27,59
336011,6,30,8,22,52
336012,53,41,58,11,52
336013,32,32,101,15,47
336014,40,60,42,52,112
336015,10,30,11,14,44
336016,31,68,74,35,103
336017,44,54,133,30,84
336018,23,44,20,44,88
336019,4,52,1,48,100
336020,32,41,74,21,62
336021,100,61,139,34,95
336022,103,28,4,9,37
336023,23,51,20,38,89
336024,100,80,25,51,131
336025,40,72,42,55,127
336026,44,31,46,9,40
336027,40,40,41,29,69
336028,101,50,74,40,90
336029,54,41,112,31,72
336030,103,53,95,27,80
336031,41,47,40,33,80
336032,31,48,33,29,77
336033,100,80,139,48,128
336034,107,29,17,24,53
336036,26,50,100,33,83
336037,44,47,133,18,65
336038,74,79,101,41,120
336039,57,57,55,37,94
336040,26,45,100,35,80
336041,44,38,133,27,65
336042,112,40,54,29,69
336043,101,39,74,25,64
336044,21,55,17,44,99
336045,31,34,32,27,61
392186,48,35,133,10,45
392187,158,19,6,16,35
392188,24,38,161,22,60
392189,57,36,97,31,67
392190,18,65,17,30,95
392191,162,32,2,21,53
392193,57,29,53,29,58
392194,110,65,87,9,74
392196,161,48,27,17,65
392197,154,39,133,34,73
392199,158,30,52,27,57
392200,29,39,26,33,72
392201,53,44,97,21,65
392202,133,68,44,51,119
392203,31,62,74,17,79
392204,132,43,9,20,63
392205,154,29,48,15,44
392206,88,41,135,31,72
392207,21,38,23,29,67
392207,21,46,20,21,67
392208,104,51,176,32,83
392209,27,50,24,19,69
392210,57,32,178,24,56
392211,88,47,187,26,73
392212,104,26,1,22,48
392213,46,66,9,55,121
392214,147,48,57,21,69
392215,74,77,183,56,133
392216,40,49,135,42,91
392217,47,29,154,22,51
392218,31,22,183,19,41
392219,20,49,18,46,95
392220,110,44,135,15,59
392221,56,58,54,32,90
392222,23,45,18,36,81
392223,154,59,85,44,103
392224,110,35,88,17,52
392225,60,20,147,17,37
392226,4,43,2,22,65
392227,133,41,71,37,78
392228,56,41,112,18,59
392229,8,38,52,18,56
392230,35,36,168,25,61
392231,26,33,27,18,51
392232,18,44,20,23,67
392233,53,43,97,23,66
392234,26,40,68,12,52
392235,110,52,135,33,85
392236,2,52,104,34,86
392237,6,38,9,32,70
392238,63,40,82,13,53
392239,17,25,197,15,40
392240,41,36,40,26,62
392241,97,45,53,15,60
392242,135,40,41,39,79
392243,96,37,6,32,69
392244,97,25,57,24,49
419111,191,65,204,58,123
419112,208,55,79,51,106
419113,40,35,171,26,61
419114,87,50,104,48,98
419115,97,45,56,41,86
419116,212,29,211,29,58
419117,214,75,161,45,120
419118,20,66,23,42,108
419119,208,34,79,34,68
419120,9,44,96,42,86
419121,18,52,21,21,73
419122,56,33,97,22,55
419123,203,29,104,21,50
419124,9,43,96,40,83
419125,57,35,178,25,60
419127,162,46,204,31,77
419128,46,41,11,11,52
419129,230,34,229,24,58
419130,21,78,23,55,133
419131,224,37,183,14,51
419132,87,41,1,30,71
419133,96,38,9,27,65
419134,183,36,229,17,53
419135,50,49,210,2,51
419136,187,74,241,53,127
419137,100,22,64,20,42
419138,8,34,9,28,62
419139,88,47,40,29,76
419140,1,54,4,19,73
419141,8,42,158,31,73
419142,185,85,109,62,147
419143,79,37,208,26,63
419144,64,58,26,38,96
419145,241,36,175,19,55
419146,229,36,32,35,71
419147,20,31,18,17,48
419148,224,83,183,21,104
419149,40,47,41,46,93
419150,56,53,178,36,89
419151,227,24,26,21,45
419152,178,34,56,10,44
419153,6,38,249,24,62
419154,27,21,26,21,42
419155,154,31,133,26,57
419156,231,41,57,37,78
419157,221,45,154,5,50
419158,21,78,185,49,127
419159,158,33,46,26,59
419160,40,43,171,25,68
419161,64,63,27,20,83
419162,208,46,210,14,60
419163,1,62,203,45,107
419164,100,53,29,44,97
419165,56,41,253,9,50
419166,2,46,1,42,88
419167,79,46,208,17,63
419168,20,30,23,17,47
419169,158,29,6,20,49
419170,21,47,20,22,69
501203,125,39,21,33,72
501204,192,35,52,21,56
501205,2,41,55,36,77
501206,133,35,57,27,62
501207,171,35,157,23,58
501208,9,30,214,19,49
501209,54,42,187,39,81
501210,208,63,133,46,109
501211,185,74,23,46,120
501212,35,46,104,38,84
501213,8,35,203,25,60
501214,9,76,40,75,151
501215,2,62,64,56,118
501216,185,31,19,19,50
501217,167,63,53,61,124
501218,187,46,41,22,68
501219,87,30,40,18,48
501220,17,25,2,25,50
501221,26,49,65,40,89
501223,133,34,208,33,67
501224,64,24,2,23,47
501225,100,45,88,21,66
501226,57,54,56,30,84
501227,162,84,135,38,122
501228,41,77,187,59,136
501229,57,56,56,44,100
501230,6,40,32,25,65
501231,19,32,185,31,63
501232,8,48,162,26,74
501233,21,34,23,30,64
501234,26,58,10,31,89
501235,87,27,40,10,37
501236,192,25,32,14,39
501237,8,40,110,26,66
501238,41,30,199,22,52
501239,40,39,87,34,73
501240,52,33,85,15,48
501241,65,56,42,10,66
501242,208,51,133,42,93
501243,2,37,288,14,51
501243,17,27,104,24,51
501244,31,42,87,33,75
501245,19,72,21,61,133
501246,96,25,46,14,39
501247,9,45,216,22,67
501248,154,48,258,18,66
501248,41,55,29,11,66
501249,162,83,8,27,110
501250,23,32,109,30,62
501251,25,49,54,36,85
501252,162,44,135,21,65
501253,46,22,96,9,31
501254,19,46,185,28,74
501255,157,35,96,19,54
501256,100,30,53,22,52
501257,162,43,8,39,82
501258,20,51,23,41,92
501259,88,69,100,41,110
501260,31,36,87,15,51
501261,221,23,50,16,39
501262,167,51,100,46,97
501263,104,33,17,15,48
501264,65,31,42,28,59
501265,53,105,100,79,184
501266,19,20,62,16,36
501267,40,32,31,29,61
501268,32,89,6,43,132
501269,112,60,42,55,115
501271,162,44,8,31,75
501272,31,36,9,21,57
501273,23,34,21,26,60
501274,289,51,133,28,79
501275,162,62,260,41,103
501276,185,89,19,63,152
548311,304,50,133,14,64
548312,254,30,41,16,46
548313,88,32,275,15,47
548314,85,41,6,28,69
548315,110,34,81,18,52
548316,71,39,109,2,41
548317,104,44,266,20,64
548318,307,45,46,30,75
548319,57,27,208,19,46
548320,214,46,40,18,64
548321,158,40,64,20,60
548322,221,64,208,29,93
548323,162,62,8,38,100
548324,100,29,53,21,50
548325,204,30,132,23,53
548326,42,35,17,34,69
548327,306,44,157,21,65
548328,236,27,4,25,52
548329,204,60,85,55,115
548330,50,25,318,8,33
548331,26,44,42,42,86
548332,157,34,46,26,60
548333,9,30,40,22,52
548334,187,109,183,64,173
548335,303,58,23,57,115
548336,162,73,110,52,125
548337,204,43,266,36,79
548338,157,41,1,41,82
548339,275,40,88,35,75
548340,17,23,42,19,42
548341,110,59,135,47,106
548342,96,80,46,60,140
548344,4,48,320,34,82
548346,10,53,154,18,71
548347,41,72,64,55,127
548348,236,32,100,32,64
548349,40,49,2,43,92
548350,85,55,6,40,95
548351,17,19,42,16,35
548352,40,34,9,26,60
548353,26,82,10,65,147
548354,41,55,158,36,91
548355,162,71,8,45,116
548356,275,25,133,23,48
548357,10,39,42,28,67
548358,40,56,2,42,98
548359,32,36,6,31,67
548360,133,67,57,57,124
548361,135,62,162,26,88
548362,40,36,2,31,67
548363,32,38,266,18,56
548364,236,30,100,22,52
548365,162,55,8,36,91
548366,125,18,109,18,36
548367,162,57,135,17,74
548368,57,109,97,53,162
548369,19,38,185,36,74
548370,32,58,85,36,94
548371,10,47,42,44,91
548372,208,64,221,52,116
548373,40,61,2,37,98
548374,183,34,64,23,57
548375,87,27,276,13,40
548376,236,24,53,23,47
548377,162,127,8,73,200
548378,331,33,42,26,59
548379,187,58,262,18,76
548380,276,37,2,25,62
548381,154,53,17,15,68
548382,147,87,133,58,145
548383,31,31,63,24,55
548384,23,47,19,43,90
548385,185,42,21,27,69
548386,214,88,9,41,129
598003,40,23,9,23,46
598004,162,48,239,19,67
598005,46,24,96,10,34
598006,187,43,338,20,63
598007,221,41,50,21,62
598008,345,32,236,26,58
598010,104,25,85,12,37
598011,88,86,57,38,124
598012,19,86,185,50,136
598013,162,54,110,22,76
598014,6,48,85,30,78
598015,26,25,17,19,44
598016,57,47,221,19,66
598017,110,41,8,37,78
598018,216,47,9,16,63
598019,351,27,85,20,47
598020,254,67,46,24,91
598021,40,60,216,40,100
598023,46,22,254,16,38
598023,325,19,136,19,38
598024,32,31,85,25,56
598025,20,44,19,28,72
598026,340,29,331,19,48
598027,40,25,31,18,43
598028,162,26,79,25,51
598029,41,90,64,59,149
598030,320,80,236,47,127
598031,21,51,19,36,87
598032,162,127,135,33,160
598033,53,42,100,14,56
598034,216,31,87,20,51
598035,19,44,185,18,62
598036,216,42,214,24,66
598037,32,42,6,30,72
598038,147,46,88,17,63
598039,19,63,62,39,102
598040,46,37,254,35,72
598041,351,41,32,25,66
598042,57,63,221,20,83
598043,21,39,23,34,73
598044,42,47,340,25,72
598045,187,61,262,33,94
598046,320,48,100,46,94
598047,110,41,163,27,68
598048,31,49,9,28,77
598049,42,22,17,11,33
598050,162,74,8,55,129
598051,57,31,50,25,56
598052,6,58,85,37,95
598053,280,40,10,36,76
598054,6,53,85,44,97
598055,133,48,147,41,89
598056,21,75,19,52,127
598057,100,54,53,42,96
598058,40,31,214,12,43
598059,8,62,110,32,94
598060,27,32,96,26,58
598061,280,27,17,21,48
598062,87,18,9,15,33
598063,32,57,255,35,92
598064,236,24,139,18,42
598065,221,66,57,17,83
598066,31,56,284,42,98
598067,20,31,35,24,55
598068,207,51,88,21,72
598069,320,93,209,27,120
598070,327,25,362,23,48
598071,321,79,100,63,142
598072,358,44,191,25,69
598073,8,35,162,28,63
598074,17,45,42,42,87
598075,21,82,19,58,140
598076,10,31,42,19,50
598077,207,35,147,33,68
598078,221,32,208,15,47
729284,96,64,9,61,125
729286,154,61,52,43,104
729288,2,67,147,44,111
729290,85,41,255,34,75
729292,17,52,110,45,97
729294,96,45,46,15,60
729296,305,89,203,21,110
729298,21,35,147,16,51
729300,305,56,320,10,66
729302,147,28,2,6,34
729304,336,45,9,33,78
729306,254,69,187,58,127
729308,57,46,372,38,84
729310,32,24,48,8,32
729312,305,15,41,12,27
729312,41,16,197,11,27
729312,46,14,336,13,27
729314,185,30,154,14,44
729316,147,42,2,40,82
729318,27,24,110,17,41
729322,187,65,354,34,99
733976,2,38,21,31,69
733978,305,45,62,18,63
733980,351,34,339,15,49
733982,187,31,42,27,58
733984,46,65,40,54,119
733986,21,46,147,37,83
733988,57,50,221,43,93
733990,46,47,40,47,94
733992,305,84,320,47,131
733994,42,33,254,3,36
733996,320,39,62,13,52
733998,88,35,63,17,52
734000,147,37,303,25,62
734002,40,45,96,36,81
734004,27,83,110,43,126
734006,383,67,208,63,130
734008,314,30,32,21,51
734010,27,59,301,15,74
734012,62,54,345,36,90
734014,46,33,40,14,47
734016,351,39,85,32,71
734018,21,47,4,25,72
734020,46,38,96,12,50
734022,383,62,19,55,117
734024,158,42,88,26,68
734026,42,50,187,46,96
734028,46,42,40,21,63
734030,383,55,19,6,61
734032,276,60,46,58,118
734034,187,90,42,22,112
734036,154,41,87,40,81
734038,100,31,62,25,56
734040,20,49,303,22,71
734042,183,26,42,24,50
734044,345,42,320,41,83
734046,339,50,351,49,99
734048,46,41,96,21,62
734050,21,46,4,40,86
734052,41,69,345,34,103
734054,62,77,345,46,123
829710,57,75,372,55,130
829712,109,27,237,20,47
829714,394,30,310,17,47
829716,20,53,2,9,62
829716,2,35,147,27,62
829718,40,44,46,35,79
829720,394,37,85,13,50
829722,50,64,398,32,96
829724,187,57,42,24,81
829726,221,70,372,32,102
829728,334,55,46,52,107
829730,27,54,260,46,100
829732,85,33,351,26,59
829734,147,56,2,46,102
829736,393,47,154,26,73
829738,334,66,31,28,94
829740,32,73,85,70,143
829742,262,34,383,32,66
829744,31,40,40,25,65
829748,187,91,42,36,127
829750,147,35,21,21,56
829752,393,82,154,66,148
829754,8,51,110,47,98
829756,383,29,57,22,51
829758,2,42,21,15,57
829762,162,62,8,35,97
829764,183,28,163,17,45
829764,187,36,340,9,45
829766,393,35,87,25,60
829770,46,38,96,12,50
829772,393,54,260,45,99
829774,208,34,221,24,58
829776,8,24,162,21,45
829778,187,61,42,22,83
829780,17,59,383,50,109
829782,339,61,85,50,111
829784,8,39,88,23,62
829786,40,31,46,21,52
829788,57,32,208,24,56
829790,162,80,8,32,112
829792,216,46,161,6,52
829794,17,45,383,38,83
829796,305,43,62,19,62
829798,237,62,79,26,88
829800,110,133,8,76,209
829802,2,64,303,29,93
829804,187,35,163,28,63
829806,393,37,27,32,69
829808,8,19,162,13,32
829808,62,31,345,1,32
829810,400,61,221,24,85
829812,163,57,187,40,97
829814,303,52,21,34,86
829816,32,38,85,37,75
829820,17,50,383,48,98
829822,383,52,17,35,87
829824,110,65,236,43,108
829826,19,36,20,11,47
829828,383,67,57,50,117
980906,85,40,303,34,74
980908,46,35,40,24,59
980910,345,38,185,37,75
980912,110,82,8,71,153
980914,96,52,40,44,96
980916,303,48,158,37,85
980918,355,48,351,33,81
980920,40,50,46,38,88
980922,21,27,254,22,49
980924,345,51,185,44,95
980926,355,74,339,54,128
980928,413,35,208,26,61
980930,46,53,40,22,75
980932,57,43,208,31,74
980934,187,74,42,53,127
980936,110,83,8,61,144
980938,351,43,154,25,68
980940,187,59,42,28,87
980942,8,67,354,51,118
980944,306,31,85,25,56
980946,17,68,208,65,133
980948,306,38,303,30,68
980950,2,58,147,53,111
980952,221,51,57,18,69
980954,306,65,85,42,107
980956,339,53,421,45,98
980958,187,76,396,45,121
980960,185,36,409,27,63
980962,306,45,79,36,81
980964,31,45,334,39,84
980966,420,69,355,44,113
980968,40,54,46,46,100
980970,426,30,85,29,59
980972,254,24,71,18,42
980974,79,52,85,49,101
980976,355,52,351,15,67
980978,42,44,27,39,83
980980,276,66,31,63,129
980982,110,61,369,27,88
980984,197,27,201,22,49
980986,208,31,57,24,55
980988,420,39,351,31,70
980990,62,56,185,50,106
980992,110,129,8,97,226
980994,31,37,96,12,49
980996,187,40,42,25,65
980998,413,60,415,33,93
981000,110,59,8,54,113
981002,85,33,197,8,41
981004,162,73,8,69,142
981006,254,26,21,23,49
981008,339,40,420,31,71
981010,185,31,329,27,58
981012,2,48,21,45,93
981014,96,44,31,41,85
981016,354,38,8,28,66
981018,110,51,140,33,84
981020,163,31,187,26,57
981022,254,35,35,16,51
981024,162,76,8,32,108
